REB = "setup/countries/rebels.txt"
PIR = "setup/countries/pirates.txt"
BAR = "setup/countries/barbarians.txt"
MER = "setup/countries/mercenaries.txt"

#Used A,B,C,D,E,F,G,H,I,J,K,L,M,N,O,P,R,S,T,V
#New:
OAA = "setup/countries/modded/mOAA.txt"
OAB = "setup/countries/modded/mOAB.txt"
OAD = "setup/countries/modded/mOAD.txt"
OAE = "setup/countries/modded/mOAE.txt"
OAF = "setup/countries/modded/mOAF.txt"
OAH = "setup/countries/modded/mOAH.txt"
OAI = "setup/countries/modded/mOAI.txt"
OAJ = "setup/countries/modded/mOAJ.txt"
OAK = "setup/countries/modded/mOAK.txt"
OAO = "setup/countries/modded/mOAO.txt"
OAP = "setup/countries/modded/mOAP.txt"
OAT = "setup/countries/modded/mOAT.txt"
OAU = "setup/countries/modded/mOAU.txt"
OAW = "setup/countries/modded/mOAW.txt"
OAY = "setup/countries/modded/mOAY.txt"
OBA = "setup/countries/modded/mOBA.txt"
OBC = "setup/countries/modded/mOBC.txt"
OBK = "setup/countries/modded/mOBK.txt"
OBU = "setup/countries/modded/mOBU.txt"
OCA = "setup/countries/modded/mOCA.txt"
OCB = "setup/countries/modded/mOCB.txt"
OCC = "setup/countries/modded/mOCC.txt"
OCE = "setup/countries/modded/mOCE.txt"
OCG = "setup/countries/modded/mOCG.txt"
OCH = "setup/countries/modded/mOCH.txt"
OCK = "setup/countries/modded/mOCK.txt"
OCM = "setup/countries/modded/mOCM.txt"
OCN = "setup/countries/modded/mOCN.txt"
OCO = "setup/countries/modded/mOCO.txt"
OCP = "setup/countries/modded/mOCP.txt"
OCR = "setup/countries/modded/mOCR.txt"
OCS = "setup/countries/modded/mOCS.txt"
OCT = "setup/countries/modded/mOCT.txt"
OCU = "setup/countries/modded/mOCU.txt"
OCW = "setup/countries/modded/mOCW.txt"
OCY = "setup/countries/modded/mOCY.txt"
OCZ = "setup/countries/modded/mOCZ.txt"
ODA = "setup/countries/modded/mODA.txt"
ODB = "setup/countries/modded/mODB.txt"
ODD = "setup/countries/modded/mODD.txt"
ODF = "setup/countries/modded/mODF.txt"
ODG = "setup/countries/modded/mODG.txt"
ODH = "setup/countries/modded/mODH.txt"
ODI = "setup/countries/modded/mODI.txt"
ODJ = "setup/countries/modded/mODJ.txt"
ODK = "setup/countries/modded/mODK.txt"
ODL = "setup/countries/modded/mODL.txt"
ODM = "setup/countries/modded/mODM.txt"
ODN = "setup/countries/modded/mODN.txt"
ODO = "setup/countries/modded/mODO.txt"
ODP = "setup/countries/modded/mODP.txt"
ODR = "setup/countries/modded/mODR.txt"
ODS = "setup/countries/modded/mODS.txt"
ODT = "setup/countries/modded/mODT.txt"
ODU = "setup/countries/modded/mODU.txt"
ODW = "setup/countries/modded/mODW.txt"
ODY = "setup/countries/modded/mODY.txt"
OEA = "setup/countries/modded/mOEA.txt"

MAA = "setup/countries/modded/mMAA.txt"
MAB = "setup/countries/modded/mMAB.txt"
MAC = "setup/countries/modded/mMAC.txt"
MAD = "setup/countries/modded/mMAD.txt"
MAE = "setup/countries/modded/mMAE.txt"
MAF = "setup/countries/modded/mMAF.txt"
MAG = "setup/countries/modded/mMAG.txt"
MAH = "setup/countries/modded/mMAH.txt"
MAI = "setup/countries/modded/mMAI.txt"
MAJ = "setup/countries/modded/mMAJ.txt"
MAK = "setup/countries/modded/mMAK.txt"
MAL = "setup/countries/modded/mMAL.txt"
MAM = "setup/countries/modded/mMAM.txt"
MAN = "setup/countries/modded/mMAN.txt"
MAO = "setup/countries/modded/mMAO.txt"
MAP = "setup/countries/modded/mMAP.txt"
MAR = "setup/countries/modded/mMAR.txt"
MAS = "setup/countries/modded/mMAS.txt"
MAT = "setup/countries/modded/mMAT.txt"
MAU = "setup/countries/modded/mMAU.txt"
MAW = "setup/countries/modded/mMAW.txt"
MAY = "setup/countries/modded/mMAY.txt"
MAZ = "setup/countries/modded/mMAZ.txt"
MBB = "setup/countries/modded/mMBB.txt"
MBC = "setup/countries/modded/mMBC.txt"
MBD = "setup/countries/modded/mMBD.txt"
MBE = "setup/countries/modded/mMBE.txt"
MBF = "setup/countries/modded/mMBF.txt"
MBG = "setup/countries/modded/mMBG.txt"
MBH = "setup/countries/modded/mMBH.txt"
MBI = "setup/countries/modded/mMBI.txt"
MBJ = "setup/countries/modded/mMBJ.txt"
MBK = "setup/countries/modded/mMBK.txt"
MBL = "setup/countries/modded/mMBL.txt"
MBM = "setup/countries/modded/mMBM.txt"
MBN = "setup/countries/modded/mMBN.txt"
MBO = "setup/countries/modded/mMBO.txt"
MBR = "setup/countries/modded/mMBR.txt"
MBS = "setup/countries/modded/mMBS.txt"
MBT = "setup/countries/modded/mMBT.txt"
MBW = "setup/countries/modded/mMBW.txt"
MBY = "setup/countries/modded/mMBY.txt"
MBZ = "setup/countries/modded/mMBZ.txt"
MCA = "setup/countries/modded/mMCA.txt"
MCB = "setup/countries/modded/mMCB.txt"
MCC = "setup/countries/modded/mMCC.txt"
MCE = "setup/countries/modded/mMCE.txt"
MCG = "setup/countries/modded/mMCG.txt"
MCH = "setup/countries/modded/mMCH.txt"
MCI = "setup/countries/modded/mMCI.txt"
MCK = "setup/countries/modded/mMCK.txt"
MCM = "setup/countries/modded/mMCM.txt"
MCN = "setup/countries/modded/mMCN.txt"
MCO = "setup/countries/modded/mMCO.txt"
MCP = "setup/countries/modded/mMCP.txt"
MCS = "setup/countries/modded/mMCS.txt"
MCT = "setup/countries/modded/mMCT.txt"
MCW = "setup/countries/modded/mMCW.txt"
MCY = "setup/countries/modded/mMCY.txt"
MCZ = "setup/countries/modded/mMCZ.txt"
MDA = "setup/countries/modded/mMDA.txt"
MDB = "setup/countries/modded/mMDB.txt"
MDC = "setup/countries/modded/mMDC.txt"
MDD = "setup/countries/modded/mMDD.txt"
MDE = "setup/countries/modded/mMDE.txt"
MDF = "setup/countries/modded/mMDF.txt"

SAA = "setup/countries/modded/mSAA.txt"
SAB = "setup/countries/modded/mSAB.txt"
SAC = "setup/countries/modded/mSAC.txt"
SAD = "setup/countries/modded/mSAD.txt"
SAE = "setup/countries/modded/mSAE.txt"
SAF = "setup/countries/modded/mSAF.txt"
SAG = "setup/countries/modded/mSAG.txt"
SAH = "setup/countries/modded/mSAH.txt"
SAJ = "setup/countries/modded/mSAJ.txt"
SAK = "setup/countries/modded/mSAK.txt"
SAL = "setup/countries/modded/mSAL.txt"
SAM = "setup/countries/modded/mSAM.txt"
SAN = "setup/countries/modded/mSAN.txt"
SAO = "setup/countries/modded/mSAO.txt"
SAP = "setup/countries/modded/mSAP.txt"
SAR = "setup/countries/modded/mSAR.txt"
SAS = "setup/countries/modded/mSAS.txt"
SAT = "setup/countries/modded/mSAT.txt"
SAU = "setup/countries/modded/mSAU.txt"
SAW = "setup/countries/modded/mSAW.txt"
SAY = "setup/countries/modded/mSAY.txt"
SAZ = "setup/countries/modded/mSAZ.txt"
SBA = "setup/countries/modded/mSBA.txt"
SBB = "setup/countries/modded/mSBB.txt"
SBC = "setup/countries/modded/mSBC.txt"
SBD = "setup/countries/modded/mSBD.txt"
SBE = "setup/countries/modded/mSBE.txt"
SBF = "setup/countries/modded/mSBF.txt"
SBG = "setup/countries/modded/mSBG.txt"
SBH = "setup/countries/modded/mSBH.txt"
SBI = "setup/countries/modded/mSBI.txt"
SBJ = "setup/countries/modded/mSBJ.txt"
SBK = "setup/countries/modded/mSBK.txt"
SBL = "setup/countries/modded/mSBL.txt"
SBM = "setup/countries/modded/mSBM.txt"
SBN = "setup/countries/modded/mSBN.txt"
SBO = "setup/countries/modded/mSBO.txt"
SBP = "setup/countries/modded/mSBP.txt"
SBR = "setup/countries/modded/mSBR.txt"
SBS = "setup/countries/modded/mSBS.txt"
SBT = "setup/countries/modded/mSBT.txt"
SBU = "setup/countries/modded/mSBU.txt"
SBW = "setup/countries/modded/mSBW.txt"
SBY = "setup/countries/modded/mSBY.txt"
SBZ = "setup/countries/modded/mSBZ.txt"
SCA = "setup/countries/modded/mSCA.txt"
SCB = "setup/countries/modded/mSCB.txt"
SCC = "setup/countries/modded/mSCC.txt"
SCD = "setup/countries/modded/mSCD.txt"
SCE = "setup/countries/modded/mSCE.txt"
SCF = "setup/countries/modded/mSCF.txt"
SCG = "setup/countries/modded/mSCG.txt"
SCH = "setup/countries/modded/mSCH.txt"
SCI = "setup/countries/modded/mSCI.txt"
SCJ = "setup/countries/modded/mSCJ.txt"
SCK = "setup/countries/modded/mSCK.txt"
SCL = "setup/countries/modded/mSCL.txt"
SCM = "setup/countries/modded/mSCM.txt"
SCN = "setup/countries/modded/mSCN.txt"
SCO = "setup/countries/modded/mSCO.txt"
SCP = "setup/countries/modded/mSCP.txt"
SCR = "setup/countries/modded/mSCR.txt"
SCS = "setup/countries/modded/mSCS.txt"
SCT = "setup/countries/modded/mSCT.txt"
SCU = "setup/countries/modded/mSCU.txt"
SCW = "setup/countries/modded/mSCW.txt"
SCY = "setup/countries/modded/mSCY.txt"
SCZ = "setup/countries/modded/mSCZ.txt"
SDA = "setup/countries/modded/mSDA.txt"
SDB = "setup/countries/modded/mSDB.txt"
SDC = "setup/countries/modded/mSDC.txt"
SDD = "setup/countries/modded/mSDD.txt"
SDE = "setup/countries/modded/mSDE.txt"
SDF = "setup/countries/modded/mSDF.txt"
SDG = "setup/countries/modded/mSDG.txt"
SDH = "setup/countries/modded/mSDH.txt"
SDI = "setup/countries/modded/mSDI.txt"
SDJ = "setup/countries/modded/mSDJ.txt"
SDK = "setup/countries/modded/mSDK.txt"
SDL = "setup/countries/modded/mSDL.txt"
SDM = "setup/countries/modded/mSDM.txt"
SDN = "setup/countries/modded/mSDN.txt"
SDO = "setup/countries/modded/mSDO.txt"
SDP = "setup/countries/modded/mSDP.txt"
SDR = "setup/countries/modded/mSDR.txt"
SDS = "setup/countries/modded/mSDS.txt"
SDT = "setup/countries/modded/mSDT.txt"
SDU = "setup/countries/modded/mSDU.txt"
SDW = "setup/countries/modded/mSDW.txt"
SDY = "setup/countries/modded/mSDY.txt"
SDZ = "setup/countries/modded/mSDZ.txt"
SEA = "setup/countries/modded/mSEA.txt"
SEB = "setup/countries/modded/mSEB.txt"
SEC = "setup/countries/modded/mSEC.txt"
SED = "setup/countries/modded/mSED.txt"
SEE = "setup/countries/modded/mSEE.txt"
SEF = "setup/countries/modded/mSEF.txt"
SEG = "setup/countries/modded/mSEG.txt"
SEH = "setup/countries/modded/mSEH.txt"
SEI = "setup/countries/modded/mSEI.txt"
SEJ = "setup/countries/modded/mSEJ.txt"
SEK = "setup/countries/modded/mSEK.txt"
SEL = "setup/countries/modded/mSEL.txt"
SEM = "setup/countries/modded/mSEM.txt"
SEN = "setup/countries/modded/mSEN.txt"
SEO = "setup/countries/modded/mSEO.txt"
SEP = "setup/countries/modded/mSEP.txt"
SER = "setup/countries/modded/mSER.txt"
SET = "setup/countries/modded/mSET.txt"
SEU = "setup/countries/modded/mSEU.txt"
SEW = "setup/countries/modded/mSEW.txt"
SEY = "setup/countries/modded/mSEY.txt"
SEZ = "setup/countries/modded/mSEZ.txt"
SFA = "setup/countries/modded/mSFA.txt"
SFC = "setup/countries/modded/mSFC.txt"
SFD = "setup/countries/modded/mSFD.txt"
SFE = "setup/countries/modded/mSFE.txt"
SFF = "setup/countries/modded/mSFF.txt"
SFG = "setup/countries/modded/mSFG.txt"
SFH = "setup/countries/modded/mSFH.txt"
SFI = "setup/countries/modded/mSFI.txt"
SFJ = "setup/countries/modded/mSFJ.txt"
SFK = "setup/countries/modded/mSFK.txt"
SFL = "setup/countries/modded/mSFL.txt"
SFM = "setup/countries/modded/mSFM.txt"
SFN = "setup/countries/modded/mSFN.txt"

FAA = "setup/countries/modded/mFAA.txt"
FAB = "setup/countries/modded/mFAB.txt"
FAC = "setup/countries/modded/mFAC.txt"
FAD = "setup/countries/modded/mFAD.txt"
FAE = "setup/countries/modded/mFAE.txt"
FAF = "setup/countries/modded/mFAF.txt"
FAG = "setup/countries/modded/mFAG.txt"
FAH = "setup/countries/modded/mFAH.txt"
FAI = "setup/countries/modded/mFAI.txt"
FAJ = "setup/countries/modded/mFAJ.txt"
FAK = "setup/countries/modded/mFAK.txt"
FAL = "setup/countries/modded/mFAL.txt"
FAM = "setup/countries/modded/mFAM.txt"
FAN = "setup/countries/modded/mFAN.txt"
FAO = "setup/countries/modded/mFAO.txt"
FAP = "setup/countries/modded/mFAP.txt"
FAR = "setup/countries/modded/mFAR.txt"
FAS = "setup/countries/modded/mFAS.txt"
FAT = "setup/countries/modded/mFAT.txt"
FAU = "setup/countries/modded/mFAU.txt"
FAW = "setup/countries/modded/mFAW.txt"
FAY = "setup/countries/modded/mFAY.txt"
FAZ = "setup/countries/modded/mFAZ.txt"
FBA = "setup/countries/modded/mFBA.txt"
FBB = "setup/countries/modded/mFBB.txt"
FBC = "setup/countries/modded/mFBC.txt"
FBD = "setup/countries/modded/mFBD.txt"
FBE = "setup/countries/modded/mFBE.txt"
FBF = "setup/countries/modded/mFBF.txt"
FBG = "setup/countries/modded/mFBG.txt"
FBH = "setup/countries/modded/mFBH.txt"
FBI = "setup/countries/modded/mFBI.txt"
FBJ = "setup/countries/modded/mFBJ.txt"
FBK = "setup/countries/modded/mFBK.txt"
FBL = "setup/countries/modded/mFBL.txt"
FBM = "setup/countries/modded/mFBM.txt"
FBN = "setup/countries/modded/mFBN.txt"
FBO = "setup/countries/modded/mFBO.txt"
FBP = "setup/countries/modded/mFBP.txt"
FBR = "setup/countries/modded/mFBR.txt"
FBS = "setup/countries/modded/mFBS.txt"
FBT = "setup/countries/modded/mFBT.txt"
FBU = "setup/countries/modded/mFBU.txt"
FBW = "setup/countries/modded/mFBW.txt"
FBY = "setup/countries/modded/mFBY.txt"
FBZ = "setup/countries/modded/mFBZ.txt"
FCA = "setup/countries/modded/mFCA.txt"
FCB = "setup/countries/modded/mFCB.txt"
FCC = "setup/countries/modded/mFCC.txt"
FCD = "setup/countries/modded/mFCD.txt"
FCE = "setup/countries/modded/mFCE.txt"
FCF = "setup/countries/modded/mFCF.txt"
FCG = "setup/countries/modded/mFCG.txt"
FCH = "setup/countries/modded/mFCH.txt"
FCI = "setup/countries/modded/mFCI.txt"
FCJ = "setup/countries/modded/mFCJ.txt"
FCK = "setup/countries/modded/mFCK.txt"
FCL = "setup/countries/modded/mFCL.txt"
FCM = "setup/countries/modded/mFCM.txt"
FCN = "setup/countries/modded/mFCN.txt"
FCO = "setup/countries/modded/mFCO.txt"
FCP = "setup/countries/modded/mFCP.txt"
FCR = "setup/countries/modded/mFCR.txt"
FCS = "setup/countries/modded/mFCS.txt"
FCT = "setup/countries/modded/mFCT.txt"
FCU = "setup/countries/modded/mFCU.txt"
FCW = "setup/countries/modded/mFCW.txt"
FCY = "setup/countries/modded/mFCY.txt"
FCZ = "setup/countries/modded/mFCZ.txt"
FDA = "setup/countries/modded/mFDA.txt"
FDB = "setup/countries/modded/mFDB.txt"
FDC = "setup/countries/modded/mFDC.txt"
FDD = "setup/countries/modded/mFDD.txt"
FDE = "setup/countries/modded/mFDE.txt"
FDF = "setup/countries/modded/mFDF.txt"
FDG = "setup/countries/modded/mFDG.txt"
FDH = "setup/countries/modded/mFDH.txt"
FDI = "setup/countries/modded/mFDI.txt"
FDJ = "setup/countries/modded/mFDJ.txt"
FDK = "setup/countries/modded/mFDK.txt"
FDL = "setup/countries/modded/mFDL.txt"
FDM = "setup/countries/modded/mFDM.txt"
FDN = "setup/countries/modded/mFDN.txt"
FDO = "setup/countries/modded/mFDO.txt"
FDP = "setup/countries/modded/mFDP.txt"
FDR = "setup/countries/modded/mFDR.txt"
FDS = "setup/countries/modded/mFDS.txt"
FDT = "setup/countries/modded/mFDT.txt"
FDU = "setup/countries/modded/mFDU.txt"
FDW = "setup/countries/modded/mFDW.txt"
FEA = "setup/countries/modded/mFEA.txt"
FEC = "setup/countries/modded/mFEC.txt"
FED = "setup/countries/modded/mFED.txt"
FEE = "setup/countries/modded/mFEE.txt"
FEF = "setup/countries/modded/mFEF.txt"
FEG = "setup/countries/modded/mFEG.txt"
FEH = "setup/countries/modded/mFEH.txt"
FEI = "setup/countries/modded/mFEI.txt"
FEJ = "setup/countries/modded/mFEJ.txt"
FEK = "setup/countries/modded/mFEK.txt"
FEL = "setup/countries/modded/mFEL.txt"
FEM = "setup/countries/modded/mFEM.txt"
FEN = "setup/countries/modded/mFEN.txt"
FEO = "setup/countries/modded/mFEO.txt"
FEP = "setup/countries/modded/mFEP.txt"
FER = "setup/countries/modded/mFER.txt"
FES = "setup/countries/modded/mFES.txt"
FET = "setup/countries/modded/mFET.txt"
FEU = "setup/countries/modded/mFEU.txt"
FEW = "setup/countries/modded/mFEW.txt"
FEY = "setup/countries/modded/mFEY.txt"
FEZ = "setup/countries/modded/mFEZ.txt"
FFA = "setup/countries/modded/mFFA.txt"
FFB = "setup/countries/modded/mFFB.txt"
FFC = "setup/countries/modded/mFFC.txt"
FFD = "setup/countries/modded/mFFD.txt"
FFE = "setup/countries/modded/mFFE.txt"
FFF = "setup/countries/modded/mFFF.txt"
FFG = "setup/countries/modded/mFFG.txt"
FFH = "setup/countries/modded/mFFH.txt"
FFI = "setup/countries/modded/mFFI.txt"
FFJ = "setup/countries/modded/mFFJ.txt"

IAA = "setup/countries/modded/mIAA.txt"
IAB = "setup/countries/modded/mIAB.txt"
IAC = "setup/countries/modded/mIAC.txt"
IAD = "setup/countries/modded/mIAD.txt"
IAE = "setup/countries/modded/mIAE.txt"
IAF = "setup/countries/modded/mIAF.txt"
IAG = "setup/countries/modded/mIAG.txt"
IAH = "setup/countries/modded/mIAH.txt"
IAI = "setup/countries/modded/mIAI.txt"
IAJ = "setup/countries/modded/mIAJ.txt"
IAK = "setup/countries/modded/mIAK.txt"
IAL = "setup/countries/modded/mIAL.txt"
IAM = "setup/countries/modded/mIAM.txt"
IAN = "setup/countries/modded/mIAN.txt"
IAO = "setup/countries/modded/mIAO.txt"
IAP = "setup/countries/modded/mIAP.txt"
IAR = "setup/countries/modded/mIAR.txt"
IAS = "setup/countries/modded/mIAS.txt"
IAT = "setup/countries/modded/mIAT.txt"
IAU = "setup/countries/modded/mIAU.txt"
IAW = "setup/countries/modded/mIAW.txt"
IAY = "setup/countries/modded/mIAY.txt"
IAZ = "setup/countries/modded/mIAZ.txt"
IBC = "setup/countries/modded/mIBC.txt"
IBD = "setup/countries/modded/mIBD.txt"
IBE = "setup/countries/modded/mIBE.txt"
IBF = "setup/countries/modded/mIBF.txt"
IBG = "setup/countries/modded/mIBG.txt"
IBH = "setup/countries/modded/mIBH.txt"
IBI = "setup/countries/modded/mIBI.txt"
IBJ = "setup/countries/modded/mIBJ.txt"
IBK = "setup/countries/modded/mIBK.txt"
IBM = "setup/countries/modded/mIBM.txt"
IBN = "setup/countries/modded/mIBN.txt"
IBO = "setup/countries/modded/mIBO.txt"
IBP = "setup/countries/modded/mIBP.txt"
IBR = "setup/countries/modded/mIBR.txt"
IBS = "setup/countries/modded/mIBS.txt"
IBT = "setup/countries/modded/mIBT.txt"
IBU = "setup/countries/modded/mIBU.txt"
IBW = "setup/countries/modded/mIBW.txt"
IBY = "setup/countries/modded/mIBY.txt"
IBZ = "setup/countries/modded/mIBZ.txt"
ICA = "setup/countries/modded/mICA.txt"
ICB = "setup/countries/modded/mICB.txt"
ICC = "setup/countries/modded/mICC.txt"
ICD = "setup/countries/modded/mICD.txt"
ICE = "setup/countries/modded/mICE.txt"
ICF = "setup/countries/modded/mICF.txt"
ICG = "setup/countries/modded/mICG.txt"
ICH = "setup/countries/modded/mICH.txt"
ICI = "setup/countries/modded/mICI.txt"
ICJ = "setup/countries/modded/mICJ.txt"
ICK = "setup/countries/modded/mICK.txt"
ICL = "setup/countries/modded/mICL.txt"
ICM = "setup/countries/modded/mICM.txt"
ICN = "setup/countries/modded/mICN.txt"
ICO = "setup/countries/modded/mICO.txt"
ICP = "setup/countries/modded/mICP.txt"
ICR = "setup/countries/modded/mICR.txt"
ICS = "setup/countries/modded/mICS.txt"
ICT = "setup/countries/modded/mICT.txt"
ICU = "setup/countries/modded/mICU.txt"
ICW = "setup/countries/modded/mICW.txt"
ICY = "setup/countries/modded/mICY.txt"
ICZ = "setup/countries/modded/mICZ.txt"
IDA = "setup/countries/modded/mIDA.txt"
IDB = "setup/countries/modded/mIDB.txt"
IDC = "setup/countries/modded/mIDC.txt"
IDD = "setup/countries/modded/mIDD.txt"
IDE = "setup/countries/modded/mIDE.txt"
IDG = "setup/countries/modded/mIDG.txt"
IDH = "setup/countries/modded/mIDH.txt"
IDI = "setup/countries/modded/mIDI.txt"
IDJ = "setup/countries/modded/mIDJ.txt"
IDK = "setup/countries/modded/mIDK.txt"
IDL = "setup/countries/modded/mIDL.txt"
IDM = "setup/countries/modded/mIDM.txt"
IDN = "setup/countries/modded/mIDN.txt"
IDO = "setup/countries/modded/mIDO.txt"
IDP = "setup/countries/modded/mIDP.txt"
IDR = "setup/countries/modded/mIDR.txt"
IDS = "setup/countries/modded/mIDS.txt"
IDT = "setup/countries/modded/mIDT.txt"
IDU = "setup/countries/modded/mIDU.txt"
IDW = "setup/countries/modded/mIDW.txt"
IDY = "setup/countries/modded/mIDY.txt"
IDZ = "setup/countries/modded/mIDZ.txt"
IEA = "setup/countries/modded/mIEA.txt"
IEB = "setup/countries/modded/mIEB.txt"
IEC = "setup/countries/modded/mIEC.txt"
IED = "setup/countries/modded/mIED.txt"
IEE = "setup/countries/modded/mIEE.txt"
IEF = "setup/countries/modded/mIEF.txt"
IEG = "setup/countries/modded/mIEG.txt"
IEH = "setup/countries/modded/mIEH.txt"
IEI = "setup/countries/modded/mIEI.txt"
IEJ = "setup/countries/modded/mIEJ.txt"
IEK = "setup/countries/modded/mIEK.txt"
IEL = "setup/countries/modded/mIEL.txt"
IEM = "setup/countries/modded/mIEM.txt"
IEN = "setup/countries/modded/mIEN.txt"
IEO = "setup/countries/modded/mIEO.txt"
IEP = "setup/countries/modded/mIEP.txt"
IER = "setup/countries/modded/mIER.txt"
IES = "setup/countries/modded/mIES.txt"

BAA = "setup/countries/modded/mBAA.txt"
BAB = "setup/countries/modded/mBAB.txt"
BAC = "setup/countries/modded/mBAC.txt"
BAD = "setup/countries/modded/mBAD.txt"
BAE = "setup/countries/modded/mBAE.txt"
BAF = "setup/countries/modded/mBAF.txt"
BAG = "setup/countries/modded/mBAG.txt"
BAH = "setup/countries/modded/mBAH.txt"
BAI = "setup/countries/modded/mBAI.txt"
BAJ = "setup/countries/modded/mBAJ.txt"
BAK = "setup/countries/modded/mBAK.txt"
BAL = "setup/countries/modded/mBAL.txt"
BAM = "setup/countries/modded/mBAM.txt"
BAN = "setup/countries/modded/mBAN.txt"
BAO = "setup/countries/modded/mBAO.txt"
BAP = "setup/countries/modded/mBAP.txt"
BAS = "setup/countries/modded/mBAS.txt"
BAT = "setup/countries/modded/mBAT.txt"
BAU = "setup/countries/modded/mBAU.txt"
BAW = "setup/countries/modded/mBAW.txt"
BAY = "setup/countries/modded/mBAY.txt"
BAZ = "setup/countries/modded/mBAZ.txt"
BBA = "setup/countries/modded/mBBA.txt"
BBB = "setup/countries/modded/mBBB.txt"
BBC = "setup/countries/modded/mBBC.txt"
BBD = "setup/countries/modded/mBBD.txt"
BBE = "setup/countries/modded/mBBE.txt"
BBF = "setup/countries/modded/mBBF.txt"
BBG = "setup/countries/modded/mBBG.txt"
BBH = "setup/countries/modded/mBBH.txt"
BBI = "setup/countries/modded/mBBI.txt"
BBJ = "setup/countries/modded/mBBJ.txt"
BBK = "setup/countries/modded/mBBK.txt"
BBL = "setup/countries/modded/mBBL.txt"

CAA = "setup/countries/modded/mCAA.txt"
CAB = "setup/countries/modded/mCAB.txt"
CAC = "setup/countries/modded/mCAC.txt"
CAD = "setup/countries/modded/mCAD.txt"
CAE = "setup/countries/modded/mCAE.txt"
CAF = "setup/countries/modded/mCAF.txt"
CAG = "setup/countries/modded/mCAG.txt"
CAH = "setup/countries/modded/mCAH.txt"
CAI = "setup/countries/modded/mCAI.txt"
CAJ = "setup/countries/modded/mCAJ.txt"
CAK = "setup/countries/modded/mCAK.txt"
CAM = "setup/countries/modded/mCAM.txt"
CAN = "setup/countries/modded/mCAN.txt"
CAO = "setup/countries/modded/mCAO.txt"
CAP = "setup/countries/modded/mCAP.txt"
CAR = "setup/countries/modded/mCAR.txt"
CAS = "setup/countries/modded/mCAS.txt"
CAT = "setup/countries/modded/mCAT.txt"
CAU = "setup/countries/modded/mCAU.txt"
CAW = "setup/countries/modded/mCAW.txt"
CAY = "setup/countries/modded/mCAY.txt"
CAZ = "setup/countries/modded/mCAZ.txt"
CBA = "setup/countries/modded/mCBA.txt"
CBB = "setup/countries/modded/mCBB.txt"
CBC = "setup/countries/modded/mCBC.txt"
CBD = "setup/countries/modded/mCBD.txt"
CBE = "setup/countries/modded/mCBE.txt"
CBF = "setup/countries/modded/mCBF.txt"
CBG = "setup/countries/modded/mCBG.txt"
CBH = "setup/countries/modded/mCBH.txt"
CBI = "setup/countries/modded/mCBI.txt"
CBJ = "setup/countries/modded/mCBJ.txt"
CBK = "setup/countries/modded/mCBK.txt"
CBL = "setup/countries/modded/mCBL.txt"
CBM = "setup/countries/modded/mCBM.txt"
CBN = "setup/countries/modded/mCBN.txt"
CBO = "setup/countries/modded/mCBO.txt"
CBP = "setup/countries/modded/mCBP.txt"
CBR = "setup/countries/modded/mCBR.txt"
CBS = "setup/countries/modded/mCBS.txt"
CBT = "setup/countries/modded/mCBT.txt"
CBU = "setup/countries/modded/mCBU.txt"
CBW = "setup/countries/modded/mCBW.txt"
CBY = "setup/countries/modded/mCBY.txt"
CCA = "setup/countries/modded/mCCA.txt"
CCB = "setup/countries/modded/mCCB.txt"
CCC = "setup/countries/modded/mCCC.txt"
CCD = "setup/countries/modded/mCCD.txt"
CCE = "setup/countries/modded/mCCE.txt"
CCF = "setup/countries/modded/mCCF.txt"
CCG = "setup/countries/modded/mCCG.txt"
CCH = "setup/countries/modded/mCCH.txt"
CCI = "setup/countries/modded/mCCI.txt"
CCJ = "setup/countries/modded/mCCJ.txt"
CCK = "setup/countries/modded/mCCK.txt"
CCL = "setup/countries/modded/mCCL.txt"
CCM = "setup/countries/modded/mCCM.txt"
CCN = "setup/countries/modded/mCCN.txt"
CCO = "setup/countries/modded/mCCO.txt"
CCP = "setup/countries/modded/mCCP.txt"
CCR = "setup/countries/modded/mCCR.txt"
CCS = "setup/countries/modded/mCCS.txt"
CCT = "setup/countries/modded/mCCT.txt"
CCU = "setup/countries/modded/mCCU.txt"
CCW = "setup/countries/modded/mCCW.txt"
CCY = "setup/countries/modded/mCCY.txt"
CCZ = "setup/countries/modded/mCCZ.txt"

EAA = "setup/countries/modded/mEAA.txt"
EAI = "setup/countries/modded/mEAI.txt"
EAB = "setup/countries/modded/mEAB.txt"
EAH = "setup/countries/modded/mEAH.txt"
EAG = "setup/countries/modded/mEAG.txt"
EAD = "setup/countries/modded/mEAD.txt"
EAJ = "setup/countries/modded/mEAJ.txt"
EAK = "setup/countries/modded/mEAK.txt"
EAL = "setup/countries/modded/mEAL.txt"
EAM = "setup/countries/modded/mEAM.txt"
EAN = "setup/countries/modded/mEAN.txt"
EAO = "setup/countries/modded/mEAO.txt"
EAP = "setup/countries/modded/mEAP.txt"
EAR = "setup/countries/modded/mEAR.txt"
EAS = "setup/countries/modded/mEAS.txt"
EAT = "setup/countries/modded/mEAT.txt"
EAU = "setup/countries/modded/mEAU.txt"
EAW = "setup/countries/modded/mEAW.txt"
EAE = "setup/countries/modded/mEAE.txt"
EAF = "setup/countries/modded/mEAF.txt"
EAC = "setup/countries/modded/mEAC.txt"

JAA = "setup/countries/modded/mJAA.txt"
JAB = "setup/countries/modded/mJAB.txt"
JAM = "setup/countries/modded/mJAM.txt"
JAN = "setup/countries/modded/mJAN.txt"
JAO = "setup/countries/modded/mJAO.txt"
JAC = "setup/countries/modded/mJAC.txt"
JAP = "setup/countries/modded/mJAP.txt"
JAD = "setup/countries/modded/mJAD.txt"
JAR = "setup/countries/modded/mJAR.txt"
JAS = "setup/countries/modded/mJAS.txt"
JAE = "setup/countries/modded/mJAE.txt"
JAF = "setup/countries/modded/mJAF.txt"
JAG = "setup/countries/modded/mJAG.txt"
JAH = "setup/countries/modded/mJAH.txt"
JAI = "setup/countries/modded/mJAI.txt"
JAJ = "setup/countries/modded/mJAJ.txt"
JAK = "setup/countries/modded/mJAK.txt"
JAT = "setup/countries/modded/mJAT.txt"
JAU = "setup/countries/modded/mJAU.txt"
JAL = "setup/countries/modded/mJAL.txt"
JAY = "setup/countries/modded/mJAY.txt"
JAW = "setup/countries/modded/mJAW.txt"
JAZ = "setup/countries/modded/mJAZ.txt"
JBA = "setup/countries/modded/mJBA.txt"
JBB = "setup/countries/modded/mJBB.txt"
JBC = "setup/countries/modded/mJBC.txt"
JBD = "setup/countries/modded/mJBD.txt"
JBE = "setup/countries/modded/mJBE.txt"
JBF = "setup/countries/modded/mJBF.txt"
JBG = "setup/countries/modded/mJBG.txt"
JBH = "setup/countries/modded/mJBH.txt"
JBI = "setup/countries/modded/mJBI.txt"
JBJ = "setup/countries/modded/mJBJ.txt"
JBL = "setup/countries/modded/mJBL.txt"
JBM = "setup/countries/modded/mJBM.txt"
JBN = "setup/countries/modded/mJBN.txt"
JBO = "setup/countries/modded/mJBO.txt"
JBP = "setup/countries/modded/mJBP.txt"
JBR = "setup/countries/modded/mJBR.txt"
JBS = "setup/countries/modded/mJBS.txt"
JBT = "setup/countries/modded/mJBT.txt"
JBU = "setup/countries/modded/mJBU.txt"
JBW = "setup/countries/modded/mJBW.txt"
JBY = "setup/countries/modded/mJBY.txt"
JBZ = "setup/countries/modded/mJBZ.txt"
JCA = "setup/countries/modded/mJCA.txt"
JCB = "setup/countries/modded/mJCB.txt"
JCC = "setup/countries/modded/mJCC.txt"
JCD = "setup/countries/modded/mJCD.txt"
JCE = "setup/countries/modded/mJCE.txt"
JCF = "setup/countries/modded/mJCF.txt"

AAA = "setup/countries/modded/mAAA.txt"
AAB = "setup/countries/modded/mAAB.txt"
AAC = "setup/countries/modded/mAAC.txt"
AAD = "setup/countries/modded/mAAD.txt"
AAE = "setup/countries/modded/mAAE.txt"
AAF = "setup/countries/modded/mAAF.txt"
AAG = "setup/countries/modded/mAAG.txt"
AAH = "setup/countries/modded/mAAH.txt"
AAI = "setup/countries/modded/mAAI.txt"
AAJ = "setup/countries/modded/mAAJ.txt"
AAK = "setup/countries/modded/mAAK.txt"
AAL = "setup/countries/modded/mAAL.txt"
AAM = "setup/countries/modded/mAAM.txt"
AAN = "setup/countries/modded/mAAN.txt"
AAO = "setup/countries/modded/mAAO.txt"
AAP = "setup/countries/modded/mAAP.txt"
AAR = "setup/countries/modded/mAAR.txt"
AAS = "setup/countries/modded/mAAS.txt"
AAT = "setup/countries/modded/mAAT.txt"
AAU = "setup/countries/modded/mAAU.txt"
AAW = "setup/countries/modded/mAAW.txt"
AAY = "setup/countries/modded/mAAY.txt"
AAZ = "setup/countries/modded/mAAZ.txt"
ABA = "setup/countries/modded/mABA.txt"
ABB = "setup/countries/modded/mABB.txt"
ABC = "setup/countries/modded/mABC.txt"
ABD = "setup/countries/modded/mABD.txt"
ABE = "setup/countries/modded/mABE.txt"
ABF = "setup/countries/modded/mABF.txt"
ABG = "setup/countries/modded/mABG.txt"
ABH = "setup/countries/modded/mABH.txt"
ABI = "setup/countries/modded/mABI.txt"
ABJ = "setup/countries/modded/mABJ.txt"
ABK = "setup/countries/modded/mABK.txt"
ABL = "setup/countries/modded/mABL.txt"
ABM = "setup/countries/modded/mABM.txt"
ABN = "setup/countries/modded/mABN.txt"
ABO = "setup/countries/modded/mABO.txt"
ABP = "setup/countries/modded/mABP.txt"
ABR = "setup/countries/modded/mABR.txt"
ABS = "setup/countries/modded/mABS.txt"
ABT = "setup/countries/modded/mABT.txt"
ABU = "setup/countries/modded/mABU.txt"
ABW = "setup/countries/modded/mABW.txt"
ABY = "setup/countries/modded/mABY.txt"
ABZ = "setup/countries/modded/mABZ.txt"
ACA = "setup/countries/modded/mACA.txt"
ACB = "setup/countries/modded/mACB.txt"
ACC = "setup/countries/modded/mACC.txt"
ACD = "setup/countries/modded/mACD.txt"
ACE = "setup/countries/modded/mACE.txt"
ACF = "setup/countries/modded/mACF.txt"
ACG = "setup/countries/modded/mACG.txt"
ACH = "setup/countries/modded/mACH.txt"
ACI = "setup/countries/modded/mACI.txt"
ACJ = "setup/countries/modded/mACJ.txt"
ACK = "setup/countries/modded/mACK.txt"
ACL = "setup/countries/modded/mACL.txt"
ACM = "setup/countries/modded/mACM.txt"
ACN = "setup/countries/modded/mACN.txt"
ACO = "setup/countries/modded/mACO.txt"
ACP = "setup/countries/modded/mACP.txt"
ACR = "setup/countries/modded/mACR.txt"
ACS = "setup/countries/modded/mACS.txt"
ACT = "setup/countries/modded/mACT.txt"
ACU = "setup/countries/modded/mACU.txt"
ACW = "setup/countries/modded/mACW.txt"
ACY = "setup/countries/modded/mACY.txt"
ACZ = "setup/countries/modded/mACZ.txt"
ADA = "setup/countries/modded/mADA.txt"
ADD = "setup/countries/modded/mADD.txt"
ADE = "setup/countries/modded/mADE.txt"
ADG = "setup/countries/modded/mADG.txt"
ADH = "setup/countries/modded/mADH.txt"
ADI = "setup/countries/modded/mADI.txt"
ADJ = "setup/countries/modded/mADJ.txt"
ADK = "setup/countries/modded/mADK.txt"
ADL = "setup/countries/modded/mADL.txt"
ADM = "setup/countries/modded/mADM.txt"
ADN = "setup/countries/modded/mADN.txt"
ADO = "setup/countries/modded/mADO.txt"
ADP = "setup/countries/modded/mADP.txt"
ADR = "setup/countries/modded/mADR.txt"
ADS = "setup/countries/modded/mADS.txt"
ADT = "setup/countries/modded/mADT.txt"
ADU = "setup/countries/modded/mADU.txt"
ADW = "setup/countries/modded/mADW.txt"
ADY = "setup/countries/modded/mADY.txt"
ADZ = "setup/countries/modded/mADZ.txt"

KAA = "setup/countries/modded/mKAA.txt"
KAB = "setup/countries/modded/mKAB.txt"
KAD = "setup/countries/modded/mKAD.txt"
KAE = "setup/countries/modded/mKAE.txt"
KAF = "setup/countries/modded/mKAF.txt"
KAG = "setup/countries/modded/mKAG.txt"
KAH = "setup/countries/modded/mKAH.txt"
KAI = "setup/countries/modded/mKAI.txt"
KAJ = "setup/countries/modded/mKAJ.txt"
KAK = "setup/countries/modded/mKAK.txt"
KAL = "setup/countries/modded/mKAL.txt"
KAM = "setup/countries/modded/mKAM.txt"
KAN = "setup/countries/modded/mKAN.txt"
KAO = "setup/countries/modded/mKAO.txt"
KAP = "setup/countries/modded/mKAP.txt"
KAR = "setup/countries/modded/mKAR.txt"
KAS = "setup/countries/modded/mKAS.txt"
KAT = "setup/countries/modded/mKAT.txt"
KAU = "setup/countries/modded/mKAU.txt"
KAW = "setup/countries/modded/mKAW.txt"
KAY = "setup/countries/modded/mKAY.txt"
KAZ = "setup/countries/modded/mKAZ.txt"
KBA = "setup/countries/modded/mKBA.txt"
KBB = "setup/countries/modded/mKBB.txt"
KBC = "setup/countries/modded/mKBC.txt"
KBD = "setup/countries/modded/mKBD.txt"
KBE = "setup/countries/modded/mKBE.txt"
KBF = "setup/countries/modded/mKBF.txt"
KBG = "setup/countries/modded/mKBG.txt"
KBH = "setup/countries/modded/mKBH.txt"
KBI = "setup/countries/modded/mKBI.txt"
KBJ = "setup/countries/modded/mKBJ.txt"
KBK = "setup/countries/modded/mKBK.txt"
KBL = "setup/countries/modded/mKBL.txt"
KBM = "setup/countries/modded/mKBM.txt"
KBN = "setup/countries/modded/mKBN.txt"
KBO = "setup/countries/modded/mKBO.txt"
KBP = "setup/countries/modded/mKBP.txt"
KBR = "setup/countries/modded/mKBR.txt"
KBS = "setup/countries/modded/mKBS.txt"
KBT = "setup/countries/modded/mKBT.txt"
KBU = "setup/countries/modded/mKBU.txt"
KBW = "setup/countries/modded/mKBW.txt"
KBY = "setup/countries/modded/mKBY.txt"
KBZ = "setup/countries/modded/mKBZ.txt"
KCA = "setup/countries/modded/mKCA.txt"
KCB = "setup/countries/modded/mKCB.txt"
KCC = "setup/countries/modded/mKCC.txt"
KCD = "setup/countries/modded/mKCD.txt"
KCE = "setup/countries/modded/mKCE.txt"
KCF = "setup/countries/modded/mKCF.txt"
KCG = "setup/countries/modded/mKCG.txt"
KCH = "setup/countries/modded/mKCH.txt"
KCI = "setup/countries/modded/mKCI.txt"
KCJ = "setup/countries/modded/mKCJ.txt"
KCK = "setup/countries/modded/mKCK.txt"
KCL = "setup/countries/modded/mKCL.txt"
KCM = "setup/countries/modded/mKCM.txt"
KCN = "setup/countries/modded/mKCN.txt"
KCO = "setup/countries/modded/mKCO.txt"

PAA = "setup/countries/modded/mPAA.txt"
PAB = "setup/countries/modded/mPAB.txt"
PAC = "setup/countries/modded/mPAC.txt"
PAD = "setup/countries/modded/mPAD.txt"
PAE = "setup/countries/modded/mPAE.txt"
PAF = "setup/countries/modded/mPAF.txt"
PAG = "setup/countries/modded/mPAG.txt"
PAH = "setup/countries/modded/mPAH.txt"
PAJ = "setup/countries/modded/mPAJ.txt"
PAK = "setup/countries/modded/mPAK.txt"
PAM = "setup/countries/modded/mPAM.txt"
PAN = "setup/countries/modded/mPAN.txt"
PAO = "setup/countries/modded/mPAO.txt"
PAP = "setup/countries/modded/mPAP.txt"
PAT = "setup/countries/modded/mPAT.txt"
PAW = "setup/countries/modded/mPAW.txt"
PAY = "setup/countries/modded/mPAY.txt"
PAZ = "setup/countries/modded/mPAZ.txt"
PBA = "setup/countries/modded/mPBA.txt"
PBB = "setup/countries/modded/mPBB.txt"
PBC = "setup/countries/modded/mPBC.txt"
PBD = "setup/countries/modded/mPBD.txt"
PBE = "setup/countries/modded/mPBE.txt"
PBF = "setup/countries/modded/mPBF.txt"
PBG = "setup/countries/modded/mPBG.txt"
PBH = "setup/countries/modded/mPBH.txt"
PBI = "setup/countries/modded/mPBI.txt"
PBJ = "setup/countries/modded/mPBJ.txt"
PBK = "setup/countries/modded/mPBK.txt"
PBL = "setup/countries/modded/mPBL.txt"
PBM = "setup/countries/modded/mPBM.txt"
PBN = "setup/countries/modded/mPBN.txt"
PBO = "setup/countries/modded/mPBO.txt"
PBP = "setup/countries/modded/mPBP.txt"
PBR = "setup/countries/modded/mPBR.txt"
PBS = "setup/countries/modded/mPBS.txt"
PBT = "setup/countries/modded/mPBT.txt"
PBU = "setup/countries/modded/mPBU.txt"
PBW = "setup/countries/modded/mPBW.txt"
PBY = "setup/countries/modded/mPBY.txt"
PBZ = "setup/countries/modded/mPBZ.txt"
PCA = "setup/countries/modded/mPCA.txt"
PCB = "setup/countries/modded/mPCB.txt"
PCC = "setup/countries/modded/mPCC.txt"
PCD = "setup/countries/modded/mPCD.txt"
PCE = "setup/countries/modded/mPCE.txt"
PCF = "setup/countries/modded/mPCF.txt"
PCG = "setup/countries/modded/mPCG.txt"
PCH = "setup/countries/modded/mPCH.txt"
PCI = "setup/countries/modded/mPCI.txt"
PCJ = "setup/countries/modded/mPCJ.txt"
PCK = "setup/countries/modded/mPCK.txt"
PCL = "setup/countries/modded/mPCL.txt"
PCM = "setup/countries/modded/mPCM.txt"
PCN = "setup/countries/modded/mPCN.txt"
PCO = "setup/countries/modded/mPCO.txt"
PCP = "setup/countries/modded/mPCP.txt"
PCR = "setup/countries/modded/mPCR.txt"
PCS = "setup/countries/modded/mPCS.txt"
PCT = "setup/countries/modded/mPCT.txt"
PCU = "setup/countries/modded/mPCU.txt"
PCW = "setup/countries/modded/mPCW.txt"
PCY = "setup/countries/modded/mPCY.txt"
PCZ = "setup/countries/modded/mPCZ.txt"
PDA = "setup/countries/modded/mPDA.txt"
PDB = "setup/countries/modded/mPDB.txt"
PDC = "setup/countries/modded/mPDC.txt"
PDD = "setup/countries/modded/mPDD.txt"
PDE = "setup/countries/modded/mPDE.txt"
PDF = "setup/countries/modded/mPDF.txt"
PDG = "setup/countries/modded/mPDG.txt"
PDH = "setup/countries/modded/mPDH.txt"
PDI = "setup/countries/modded/mPDI.txt"
PDJ = "setup/countries/modded/mPDJ.txt"
PDK = "setup/countries/modded/mPDK.txt"
PDL = "setup/countries/modded/mPDL.txt"
PDM = "setup/countries/modded/mPDM.txt"
PDN = "setup/countries/modded/mPDN.txt"
PDO = "setup/countries/modded/mPDO.txt"
PDP = "setup/countries/modded/mPDP.txt"
PDR = "setup/countries/modded/mPDR.txt"
PDS = "setup/countries/modded/mPDS.txt"
PDT = "setup/countries/modded/mPDT.txt"
PDU = "setup/countries/modded/mPDU.txt"
PDW = "setup/countries/modded/mPDW.txt"
PDY = "setup/countries/modded/mPDY.txt"
PDZ = "setup/countries/modded/mPDZ.txt"
PEA = "setup/countries/modded/mPEA.txt"
PEB = "setup/countries/modded/mPEB.txt"
PEC = "setup/countries/modded/mPEC.txt"
PED = "setup/countries/modded/mPED.txt"
PEE = "setup/countries/modded/mPEE.txt"
PEF = "setup/countries/modded/mPEF.txt"

LAA = "setup/countries/modded/mLAA.txt"
LAB = "setup/countries/modded/mLAB.txt"
LAC = "setup/countries/modded/mLAC.txt"
LAD = "setup/countries/modded/mLAD.txt"
LAE = "setup/countries/modded/mLAE.txt"
LAF = "setup/countries/modded/mLAF.txt"
LAG = "setup/countries/modded/mLAG.txt"
LAH = "setup/countries/modded/mLAH.txt"
LAI = "setup/countries/modded/mLAI.txt"
LAJ = "setup/countries/modded/mLAJ.txt"
LAK = "setup/countries/modded/mLAK.txt"
LAL = "setup/countries/modded/mLAL.txt"
LAM = "setup/countries/modded/mLAM.txt"
LAN = "setup/countries/modded/mLAN.txt"
LAO = "setup/countries/modded/mLAO.txt"
LAT = "setup/countries/modded/mLAT.txt"
LAU = "setup/countries/modded/mLAU.txt"
LAW = "setup/countries/modded/mLAW.txt"
LAY = "setup/countries/modded/mLAY.txt"
LAZ = "setup/countries/modded/mLAZ.txt"
LBA = "setup/countries/modded/mLBA.txt"
LBB = "setup/countries/modded/mLBB.txt"
LBC = "setup/countries/modded/mLBC.txt"
LBD = "setup/countries/modded/mLBD.txt"
LBE = "setup/countries/modded/mLBE.txt"
LBF = "setup/countries/modded/mLBF.txt"
LBH = "setup/countries/modded/mLBH.txt"
LBI = "setup/countries/modded/mLBI.txt"
LBJ = "setup/countries/modded/mLBJ.txt"
LBK = "setup/countries/modded/mLBK.txt"
LBL = "setup/countries/modded/mLBL.txt"
LBM = "setup/countries/modded/mLBM.txt"
LBN = "setup/countries/modded/mLBN.txt"
LBO = "setup/countries/modded/mLBO.txt"
LBP = "setup/countries/modded/mLBP.txt"
LBR = "setup/countries/modded/mLBR.txt"
LBS = "setup/countries/modded/mLBS.txt"
LBT = "setup/countries/modded/mLBT.txt"
LBU = "setup/countries/modded/mLBU.txt"
LBW = "setup/countries/modded/mLBW.txt"
LBZ = "setup/countries/modded/mLBZ.txt"
LCA = "setup/countries/modded/mLCA.txt"
LCB = "setup/countries/modded/mLCB.txt"
LCC = "setup/countries/modded/mLCC.txt"
LCD = "setup/countries/modded/mLCD.txt"
LCE = "setup/countries/modded/mLCE.txt"
LCH = "setup/countries/modded/mLCH.txt"
LCI = "setup/countries/modded/mLCI.txt"
LCL = "setup/countries/modded/mLCL.txt"
LCM = "setup/countries/modded/mLCM.txt"
LCN = "setup/countries/modded/mLCN.txt"
LCO = "setup/countries/modded/mLCO.txt"
LCR = "setup/countries/modded/mLCR.txt"
LCT = "setup/countries/modded/mLCT.txt"

HAA = "setup/countries/modded/mHAA.txt"
HAB = "setup/countries/modded/mHAB.txt"
HAC = "setup/countries/modded/mHAC.txt"
HAD = "setup/countries/modded/mHAD.txt"
HAE = "setup/countries/modded/mHAE.txt"
HAF = "setup/countries/modded/mHAF.txt"
HAG = "setup/countries/modded/mHAG.txt"
HAH = "setup/countries/modded/mHAH.txt"
HAI = "setup/countries/modded/mHAI.txt"
HAJ = "setup/countries/modded/mHAJ.txt"
HAK = "setup/countries/modded/mHAK.txt"
HAL = "setup/countries/modded/mHAL.txt"
HAM = "setup/countries/modded/mHAM.txt"
HAN = "setup/countries/modded/mHAN.txt"
HAO = "setup/countries/modded/mHAO.txt"
HAP = "setup/countries/modded/mHAP.txt"
HAR = "setup/countries/modded/mHAR.txt"
HAS = "setup/countries/modded/mHAS.txt"
HAT = "setup/countries/modded/mHAT.txt"
HAU = "setup/countries/modded/mHAU.txt"
HAW = "setup/countries/modded/mHAW.txt"
HAY = "setup/countries/modded/mHAY.txt"
HAZ = "setup/countries/modded/mHAZ.txt"
HBA = "setup/countries/modded/mHBA.txt"
HBB = "setup/countries/modded/mHBB.txt"
HBC = "setup/countries/modded/mHBC.txt"
HBD = "setup/countries/modded/mHBD.txt"
HBE = "setup/countries/modded/mHBE.txt"
HBF = "setup/countries/modded/mHBF.txt"
HBG = "setup/countries/modded/mHBG.txt"
HBH = "setup/countries/modded/mHBH.txt"
HBI = "setup/countries/modded/mHBI.txt"
HBJ = "setup/countries/modded/mHBJ.txt"
HBK = "setup/countries/modded/mHBK.txt"
HBL = "setup/countries/modded/mHBL.txt"
HBM = "setup/countries/modded/mHBM.txt"
HBN = "setup/countries/modded/mHBN.txt"
HBO = "setup/countries/modded/mHBO.txt"
HBP = "setup/countries/modded/mHBP.txt"
HBS = "setup/countries/modded/mHBS.txt"
HBT = "setup/countries/modded/mHBT.txt"
HBU = "setup/countries/modded/mHBU.txt"
HBZ = "setup/countries/modded/mHBZ.txt"
HCB = "setup/countries/modded/mHCB.txt"
HCD = "setup/countries/modded/mHCD.txt"
HCE = "setup/countries/modded/mHCE.txt"
HCF = "setup/countries/modded/mHCF.txt"
HCG = "setup/countries/modded/mHCG.txt"
HCH = "setup/countries/modded/mHCH.txt"
HCI = "setup/countries/modded/mHCI.txt"
HCJ = "setup/countries/modded/mHCJ.txt"
HCL = "setup/countries/modded/mHCL.txt"
HCM = "setup/countries/modded/mHCM.txt"
HCN = "setup/countries/modded/mHCN.txt"
HCO = "setup/countries/modded/mHCO.txt"
HCP = "setup/countries/modded/mHCP.txt"
HCT = "setup/countries/modded/mHCT.txt"
HCY = "setup/countries/modded/mHCY.txt"
HDB = "setup/countries/modded/mHDB.txt"
HDC = "setup/countries/modded/mHDC.txt"
HDD = "setup/countries/modded/mHDD.txt"
HDE = "setup/countries/modded/mHDE.txt"
HDF = "setup/countries/modded/mHDF.txt"
HDG = "setup/countries/modded/mHDG.txt"
HDH = "setup/countries/modded/mHDH.txt"
HDI = "setup/countries/modded/mHDI.txt"
HDJ = "setup/countries/modded/mHDJ.txt"
HDK = "setup/countries/modded/mHDK.txt"
HDL = "setup/countries/modded/mHDL.txt"
HDM = "setup/countries/modded/mHDM.txt"
HDN = "setup/countries/modded/mHDN.txt"
HDO = "setup/countries/modded/mHDO.txt"
HDP = "setup/countries/modded/mHDP.txt"
HDR = "setup/countries/modded/mHDR.txt"
HDS = "setup/countries/modded/mHDS.txt"
HDT = "setup/countries/modded/mHDT.txt"
HDU = "setup/countries/modded/mHDU.txt"
HDW = "setup/countries/modded/mHDW.txt"
HDY = "setup/countries/modded/mHDY.txt"
HDZ = "setup/countries/modded/mHDZ.txt"
HEA = "setup/countries/modded/mHEA.txt"
HEB = "setup/countries/modded/mHEB.txt"

NAA = "setup/countries/modded/mNAA.txt"
NAB = "setup/countries/modded/mNAB.txt"
NAC = "setup/countries/modded/mNAC.txt"
NAD = "setup/countries/modded/mNAD.txt"
NAE = "setup/countries/modded/mNAE.txt"
NAG = "setup/countries/modded/mNAG.txt"
NAH = "setup/countries/modded/mNAH.txt"
NAI = "setup/countries/modded/mNAI.txt"
NAJ = "setup/countries/modded/mNAJ.txt"
NAK = "setup/countries/modded/mNAK.txt"
NAL = "setup/countries/modded/mNAL.txt"
NAM = "setup/countries/modded/mNAM.txt"
NAN = "setup/countries/modded/mNAN.txt"
NAO = "setup/countries/modded/mNAO.txt"
NAP = "setup/countries/modded/mNAP.txt"
NAR = "setup/countries/modded/mNAR.txt"
NAS = "setup/countries/modded/mNAS.txt"
NAT = "setup/countries/modded/mNAT.txt"
NAU = "setup/countries/modded/mNAU.txt"
NAW = "setup/countries/modded/mNAW.txt"
NAY = "setup/countries/modded/mNAY.txt"
NAZ = "setup/countries/modded/mNAZ.txt"

GAB = "setup/countries/modded/mGAB.txt"
GAC = "setup/countries/modded/mGAC.txt"
GAD = "setup/countries/modded/mGAD.txt"
GAE = "setup/countries/modded/mGAE.txt"
GAF = "setup/countries/modded/mGAF.txt"
GAG = "setup/countries/modded/mGAG.txt"
GAH = "setup/countries/modded/mGAH.txt"
GAI = "setup/countries/modded/mGAI.txt"
GAJ = "setup/countries/modded/mGAJ.txt"
GAK = "setup/countries/modded/mGAK.txt"
GAL = "setup/countries/modded/mGAL.txt"
GAM = "setup/countries/modded/mGAM.txt"
GAN = "setup/countries/modded/mGAN.txt"
GAO = "setup/countries/modded/mGAO.txt"
GAP = "setup/countries/modded/mGAP.txt"
GAR = "setup/countries/modded/mGAR.txt"
GAS = "setup/countries/modded/mGAS.txt"
GAT = "setup/countries/modded/mGAT.txt"
GAA = "setup/countries/modded/mGAA.txt"
GAW = "setup/countries/modded/mGAW.txt"
GAY = "setup/countries/modded/mGAY.txt"
GAZ = "setup/countries/modded/mGAZ.txt"
GBA = "setup/countries/modded/mGBA.txt"
GBB = "setup/countries/modded/mGBB.txt"
GBC = "setup/countries/modded/mGBC.txt"
GBD = "setup/countries/modded/mGBD.txt"
GBE = "setup/countries/modded/mGBE.txt"
GBF = "setup/countries/modded/mGBF.txt"
GBG = "setup/countries/modded/mGBG.txt"
GBH = "setup/countries/modded/mGBH.txt"
GBI = "setup/countries/modded/mGBI.txt"
GBJ = "setup/countries/modded/mGBJ.txt"
GBK = "setup/countries/modded/mGBK.txt"
GBL = "setup/countries/modded/mGBL.txt"
GBM = "setup/countries/modded/mGBM.txt"
GBN = "setup/countries/modded/mGBN.txt"
GBO = "setup/countries/modded/mGBO.txt"
GBR = "setup/countries/modded/mGBR.txt"
GBS = "setup/countries/modded/mGBS.txt"
GBT = "setup/countries/modded/mGBT.txt"
GBU = "setup/countries/modded/mGBU.txt"
GBW = "setup/countries/modded/mGBW.txt"
GBY = "setup/countries/modded/mGBY.txt"
GCA = "setup/countries/modded/mGCA.txt"
GCB = "setup/countries/modded/mGCB.txt"
GCC = "setup/countries/modded/mGCC.txt"
GCD = "setup/countries/modded/mGCD.txt"
GCE = "setup/countries/modded/mGCE.txt"
GCF = "setup/countries/modded/mGCF.txt"
GCG = "setup/countries/modded/mGCG.txt"
GCH = "setup/countries/modded/mGCH.txt"
GCI = "setup/countries/modded/mGCI.txt"
GCJ = "setup/countries/modded/mGCJ.txt"
GCK = "setup/countries/modded/mGCK.txt"
GCL = "setup/countries/modded/mGCL.txt"
GCM = "setup/countries/modded/mGCM.txt"
GCN = "setup/countries/modded/mGCN.txt"
GCO = "setup/countries/modded/mGCO.txt"
GCP = "setup/countries/modded/mGCP.txt"
GCR = "setup/countries/modded/mGCR.txt"
GCS = "setup/countries/modded/mGCS.txt"
GCT = "setup/countries/modded/mGCT.txt"
GCU = "setup/countries/modded/mGCU.txt"
GCW = "setup/countries/modded/mGCW.txt"
GCY = "setup/countries/modded/mGCY.txt"
GCZ = "setup/countries/modded/mGCZ.txt"
GDA = "setup/countries/modded/mGDA.txt"
GDC = "setup/countries/modded/mGDC.txt"
GDD = "setup/countries/modded/mGDD.txt"
GDE = "setup/countries/modded/mGDE.txt"
GDF = "setup/countries/modded/mGDF.txt"
GDG = "setup/countries/modded/mGDG.txt"
GDH = "setup/countries/modded/mGDH.txt"
GDI = "setup/countries/modded/mGDI.txt"
GDJ = "setup/countries/modded/mGDJ.txt"
GDK = "setup/countries/modded/mGDK.txt"
GDL = "setup/countries/modded/mGDL.txt"
GDM = "setup/countries/modded/mGDM.txt"
GDN = "setup/countries/modded/mGDN.txt"
GDO = "setup/countries/modded/mGDO.txt"
GDP = "setup/countries/modded/mGDP.txt"
GDR = "setup/countries/modded/mGDR.txt"
GDS = "setup/countries/modded/mGDS.txt"
GDT = "setup/countries/modded/mGDT.txt"
GDU = "setup/countries/modded/mGDU.txt"
GDW = "setup/countries/modded/mGDW.txt"
GDY = "setup/countries/modded/mGDY.txt"
GDZ = "setup/countries/modded/mGDZ.txt"
GEA = "setup/countries/modded/mGEA.txt"
GEB = "setup/countries/modded/mGEB.txt"
GEC = "setup/countries/modded/mGEC.txt"
GED = "setup/countries/modded/mGED.txt"
GEE = "setup/countries/modded/mGEE.txt"
GEF = "setup/countries/modded/mGEF.txt"
GEG = "setup/countries/modded/mGEG.txt"

TAA = "setup/countries/modded/mTAA.txt"
TAB = "setup/countries/modded/mTAB.txt"
TAC = "setup/countries/modded/mTAC.txt"
TAD = "setup/countries/modded/mTAD.txt"
TAF = "setup/countries/modded/mTAF.txt"
TAG = "setup/countries/modded/mTAG.txt"
TAH = "setup/countries/modded/mTAH.txt"
TAI = "setup/countries/modded/mTAI.txt"
TAJ = "setup/countries/modded/mTAJ.txt"
TAK = "setup/countries/modded/mTAK.txt"
TAL = "setup/countries/modded/mTAL.txt"
TAM = "setup/countries/modded/mTAM.txt"
TAN = "setup/countries/modded/mTAN.txt"
TAP = "setup/countries/modded/mTAP.txt"
TAS = "setup/countries/modded/mTAS.txt"
TAT = "setup/countries/modded/mTAT.txt"
TAU = "setup/countries/modded/mTAU.txt"
TAW = "setup/countries/modded/mTAW.txt"
TAY = "setup/countries/modded/mTAY.txt"
TAZ = "setup/countries/modded/mTAZ.txt"
TBA = "setup/countries/modded/mTBA.txt"
TBB = "setup/countries/modded/mTBB.txt"
TBC = "setup/countries/modded/mTBC.txt"
TBD = "setup/countries/modded/mTBD.txt"
TBE = "setup/countries/modded/mTBE.txt"
TBF = "setup/countries/modded/mTBF.txt"
TBG = "setup/countries/modded/mTBG.txt"
TBH = "setup/countries/modded/mTBH.txt"
TBI = "setup/countries/modded/mTBI.txt"
TBJ = "setup/countries/modded/mTBJ.txt"
TBK = "setup/countries/modded/mTBK.txt"
TBL = "setup/countries/modded/mTBL.txt"
TBM = "setup/countries/modded/mTBM.txt"
TBN = "setup/countries/modded/mTBN.txt"
TBO = "setup/countries/modded/mTBO.txt"
TBP = "setup/countries/modded/mTBP.txt"
TBR = "setup/countries/modded/mTBR.txt"
TBS = "setup/countries/modded/mTBS.txt"
TBT = "setup/countries/modded/mTBT.txt"
TBU = "setup/countries/modded/mTBU.txt"
TBW = "setup/countries/modded/mTBW.txt"
TBY = "setup/countries/modded/mTBY.txt"
TCC = "setup/countries/modded/mTCC.txt"
TCE = "setup/countries/modded/mTCE.txt"
TCF = "setup/countries/modded/mTCF.txt"
TCG = "setup/countries/modded/mTCG.txt"
TCH = "setup/countries/modded/mTCH.txt"
TCI = "setup/countries/modded/mTCI.txt"
TCJ = "setup/countries/modded/mTCJ.txt"
TCK = "setup/countries/modded/mTCK.txt"
TCL = "setup/countries/modded/mTCL.txt"
TCM = "setup/countries/modded/mTCM.txt"
TCN = "setup/countries/modded/mTCN.txt"
TCO = "setup/countries/modded/mTCO.txt"
TCP = "setup/countries/modded/mTCP.txt"
TCR = "setup/countries/modded/mTCR.txt"
TCS = "setup/countries/modded/mTCS.txt"
TCT = "setup/countries/modded/mTCT.txt"
TCU = "setup/countries/modded/mTCU.txt"
TCW = "setup/countries/modded/mTCW.txt"
TCY = "setup/countries/modded/mTCY.txt"
TCZ = "setup/countries/modded/mTCZ.txt"
TDA = "setup/countries/modded/mTDA.txt"
TDB = "setup/countries/modded/mTDB.txt"
TDC = "setup/countries/modded/mTDC.txt"
TDD = "setup/countries/modded/mTDD.txt"
TDE = "setup/countries/modded/mTDE.txt"
TDF = "setup/countries/modded/mTDF.txt"
TDG = "setup/countries/modded/mTDG.txt"
TDH = "setup/countries/modded/mTDH.txt"
TDI = "setup/countries/modded/mTDI.txt"
TDJ = "setup/countries/modded/mTDJ.txt"
TDK = "setup/countries/modded/mTDK.txt"
TDL = "setup/countries/modded/mTDL.txt"
TDM = "setup/countries/modded/mTDM.txt"
TDN = "setup/countries/modded/mTDN.txt"
TDO = "setup/countries/modded/mTDO.txt"
TDP = "setup/countries/modded/mTDP.txt"
TDR = "setup/countries/modded/mTDR.txt"
TDS = "setup/countries/modded/mTDS.txt"
TDT = "setup/countries/modded/mTDT.txt"
TDU = "setup/countries/modded/mTDU.txt"
TDW = "setup/countries/modded/mTDW.txt"
TDY = "setup/countries/modded/mTDY.txt"
TDZ = "setup/countries/modded/mTDZ.txt"
TEA = "setup/countries/modded/mTEA.txt"
TEB = "setup/countries/modded/mTEB.txt"
TEC = "setup/countries/modded/mTEC.txt"
TED = "setup/countries/modded/mTED.txt"
TEE = "setup/countries/modded/mTEE.txt"
TEF = "setup/countries/modded/mTEF.txt"
TEG = "setup/countries/modded/mTEG.txt"

DAA = "setup/countries/modded/mDAA.txt"
DAB = "setup/countries/modded/mDAB.txt"
DAC = "setup/countries/modded/mDAC.txt"
DAD = "setup/countries/modded/mDAD.txt"
DAE = "setup/countries/modded/mDAE.txt"
DAF = "setup/countries/modded/mDAF.txt"
DAG = "setup/countries/modded/mDAG.txt"
DAH = "setup/countries/modded/mDAH.txt"
DAI = "setup/countries/modded/mDAI.txt"
DAJ = "setup/countries/modded/mDAJ.txt"
DAK = "setup/countries/modded/mDAK.txt"
DAL = "setup/countries/modded/mDAL.txt"
DAM = "setup/countries/modded/mDAM.txt"
DAN = "setup/countries/modded/mDAN.txt"
DAO = "setup/countries/modded/mDAO.txt"
DAP = "setup/countries/modded/mDAP.txt"
DAR = "setup/countries/modded/mDAR.txt"
DAS = "setup/countries/modded/mDAS.txt"
DAT = "setup/countries/modded/mDAT.txt"
DAU = "setup/countries/modded/mDAU.txt"
DAW = "setup/countries/modded/mDAW.txt"
DAY = "setup/countries/modded/mDAY.txt"
DAZ = "setup/countries/modded/mDAZ.txt"
DBA = "setup/countries/modded/mDBA.txt"
DBB = "setup/countries/modded/mDBB.txt"
DBC = "setup/countries/modded/mDBC.txt"
DBD = "setup/countries/modded/mDBD.txt"
DBE = "setup/countries/modded/mDBE.txt"
DBF = "setup/countries/modded/mDBF.txt"
DBG = "setup/countries/modded/mDBG.txt"
DBH = "setup/countries/modded/mDBH.txt"
DBI = "setup/countries/modded/mDBI.txt"
DBJ = "setup/countries/modded/mDBJ.txt"
DBK = "setup/countries/modded/mDBK.txt"
DBL = "setup/countries/modded/mDBL.txt"
DBM = "setup/countries/modded/mDBM.txt"
DBN = "setup/countries/modded/mDBN.txt"
DBO = "setup/countries/modded/mDBO.txt"
DBP = "setup/countries/modded/mDBP.txt"
DBR = "setup/countries/modded/mDBR.txt"
DBS = "setup/countries/modded/mDBS.txt"
DBT = "setup/countries/modded/mDBT.txt"
DBU = "setup/countries/modded/mDBU.txt"
DBW = "setup/countries/modded/mDBW.txt"
DBY = "setup/countries/modded/mDBY.txt"
DBZ = "setup/countries/modded/mDBZ.txt"
DCA = "setup/countries/modded/mDCA.txt"
DCB = "setup/countries/modded/mDCB.txt"
DCC = "setup/countries/modded/mDCC.txt"
DCD = "setup/countries/modded/mDCD.txt"

VAA = "setup/countries/modded/mVAA.txt"
VAB = "setup/countries/modded/mVAB.txt"
VAC = "setup/countries/modded/mVAC.txt"
VAD = "setup/countries/modded/mVAD.txt"
VAE = "setup/countries/modded/mVAE.txt"
VAF = "setup/countries/modded/mVAF.txt"
VAG = "setup/countries/modded/mVAG.txt"
VAH = "setup/countries/modded/mVAH.txt"
VAI = "setup/countries/modded/mVAI.txt"
VAJ = "setup/countries/modded/mVAJ.txt"
VAK = "setup/countries/modded/mVAK.txt"
VAL = "setup/countries/modded/mVAL.txt"
VAM = "setup/countries/modded/mVAM.txt"
VAN = "setup/countries/modded/mVAN.txt"
VAO = "setup/countries/modded/mVAO.txt"
VAP = "setup/countries/modded/mVAP.txt"
VAR = "setup/countries/modded/mVAR.txt"
VAS = "setup/countries/modded/mVAS.txt"
VAT = "setup/countries/modded/mVAT.txt"
VAU = "setup/countries/modded/mVAU.txt"
VAW = "setup/countries/modded/mVAW.txt"
VAY = "setup/countries/modded/mVAY.txt"
VAZ = "setup/countries/modded/mVAZ.txt"
VBA = "setup/countries/modded/mVBA.txt"
VBB = "setup/countries/modded/mVBB.txt"
VBC = "setup/countries/modded/mVBC.txt"
VBD = "setup/countries/modded/mVBD.txt"
VBE = "setup/countries/modded/mVBE.txt"
VBF = "setup/countries/modded/mVBF.txt"
VBG = "setup/countries/modded/mVBG.txt"
VBH = "setup/countries/modded/mVBH.txt"
VBI = "setup/countries/modded/mVBI.txt"
VBJ = "setup/countries/modded/mVBJ.txt"
VBK = "setup/countries/modded/mVBK.txt"
VBL = "setup/countries/modded/mVBL.txt"
VBM = "setup/countries/modded/mVBM.txt"
VBN = "setup/countries/modded/mVBN.txt"
VBO = "setup/countries/modded/mVBO.txt"
VBP = "setup/countries/modded/mVBP.txt"
VBR = "setup/countries/modded/mVBR.txt"
VBS = "setup/countries/modded/mVBS.txt"
VBT = "setup/countries/modded/mVBT.txt"
VBU = "setup/countries/modded/mVBU.txt"
VBW = "setup/countries/modded/mVBW.txt"
VBY = "setup/countries/modded/mVBY.txt"
VBZ = "setup/countries/modded/mVBZ.txt"
VCA = "setup/countries/modded/mVCA.txt"
VCB = "setup/countries/modded/mVCB.txt"
VCC = "setup/countries/modded/mVCC.txt"
VCD = "setup/countries/modded/mVCD.txt"
VCE = "setup/countries/modded/mVCE.txt"
VCF = "setup/countries/modded/mVCF.txt"
VCG = "setup/countries/modded/mVCG.txt"
VCH = "setup/countries/modded/mVCH.txt"
VCI = "setup/countries/modded/mVCI.txt"
VCJ = "setup/countries/modded/mVCJ.txt"
VCK = "setup/countries/modded/mVCK.txt"
VCL = "setup/countries/modded/mVCL.txt"
VCM = "setup/countries/modded/mVCM.txt"
VCN = "setup/countries/modded/mVCN.txt"
VCO = "setup/countries/modded/mVCO.txt"
VCP = "setup/countries/modded/mVCP.txt"
VCR = "setup/countries/modded/mVCR.txt"
VCS = "setup/countries/modded/mVCS.txt"
VCT = "setup/countries/modded/mVCT.txt"
VCU = "setup/countries/modded/mVCU.txt"
VCW = "setup/countries/modded/mVCW.txt"
VCY = "setup/countries/modded/mVCY.txt"
VCZ = "setup/countries/modded/mVCZ.txt"
VDA = "setup/countries/modded/mVDA.txt"
VDB = "setup/countries/modded/mVDB.txt"
VDC = "setup/countries/modded/mVDC.txt"
VDD = "setup/countries/modded/mVDD.txt"
VDE = "setup/countries/modded/mVDE.txt"

RAA = "setup/countries/modded/mRAA.txt"
RAD = "setup/countries/modded/mRAD.txt"
RAE = "setup/countries/modded/mRAE.txt"
RAF = "setup/countries/modded/mRAF.txt"
RAG = "setup/countries/modded/mRAG.txt"
RAH = "setup/countries/modded/mRAH.txt"
RAI = "setup/countries/modded/mRAI.txt"
RAJ = "setup/countries/modded/mRAJ.txt"
RAK = "setup/countries/modded/mRAK.txt"
RAL = "setup/countries/modded/mRAL.txt"
RAM = "setup/countries/modded/mRAM.txt"
RAN = "setup/countries/modded/mRAN.txt"
RAO = "setup/countries/modded/mRAO.txt"
RAP = "setup/countries/modded/mRAP.txt"
RAR = "setup/countries/modded/mRAR.txt"
RAS = "setup/countries/modded/mRAS.txt"
RAT = "setup/countries/modded/mRAT.txt"
RAU = "setup/countries/modded/mRAU.txt"
RAW = "setup/countries/modded/mRAW.txt"
RAY = "setup/countries/modded/mRAY.txt"
RAZ = "setup/countries/modded/mRAZ.txt"
RBA = "setup/countries/modded/mRBA.txt"
RBB = "setup/countries/modded/mRBB.txt"
RBC = "setup/countries/modded/mRBC.txt"
RBD = "setup/countries/modded/mRBD.txt"
RBE = "setup/countries/modded/mRBE.txt"
RBF = "setup/countries/modded/mRBF.txt"
RBG = "setup/countries/modded/mRBG.txt"
RBH = "setup/countries/modded/mRBH.txt"
RBI = "setup/countries/modded/mRBI.txt"
RBJ = "setup/countries/modded/mRBJ.txt"
RBK = "setup/countries/modded/mRBK.txt"
RBL = "setup/countries/modded/mRBL.txt"
RBM = "setup/countries/modded/mRBM.txt"
RBN = "setup/countries/modded/mRBN.txt"
RBO = "setup/countries/modded/mRBO.txt"
RBP = "setup/countries/modded/mRBP.txt"
RBR = "setup/countries/modded/mRBR.txt"
RBS = "setup/countries/modded/mRBS.txt"
RBT = "setup/countries/modded/mRBT.txt"
RBU = "setup/countries/modded/mRBU.txt"
RBW = "setup/countries/modded/mRBW.txt"
RBY = "setup/countries/modded/mRBY.txt"
RBZ = "setup/countries/modded/mRBZ.txt"
RCA = "setup/countries/modded/mRCA.txt"
RCB = "setup/countries/modded/mRCB.txt"
RCC = "setup/countries/modded/mRCC.txt"
RCD = "setup/countries/modded/mRCD.txt"
RCE = "setup/countries/modded/mRCE.txt"
RCF = "setup/countries/modded/mRCF.txt"
RCG = "setup/countries/modded/mRCG.txt"
RCH = "setup/countries/modded/mRCH.txt"
RCI = "setup/countries/modded/mRCI.txt"
RCJ = "setup/countries/modded/mRCJ.txt"
RCK = "setup/countries/modded/mRCK.txt"
RCL = "setup/countries/modded/mRCL.txt"
RCM = "setup/countries/modded/mRCM.txt"
RCN = "setup/countries/modded/mRCN.txt"
RCO = "setup/countries/modded/mRCO.txt"
RCP = "setup/countries/modded/mRCP.txt"
RCR = "setup/countries/modded/mRCR.txt"
RCS = "setup/countries/modded/mRCS.txt"
RCT = "setup/countries/modded/mRCT.txt"
RCU = "setup/countries/modded/mRCU.txt"
RCW = "setup/countries/modded/mRCW.txt"
RCY = "setup/countries/modded/mRCY.txt"
RCZ = "setup/countries/modded/mRCZ.txt"
RDA = "setup/countries/modded/mRDA.txt"
RDB = "setup/countries/modded/mRDB.txt"
RDC = "setup/countries/modded/mRDC.txt"
RDD = "setup/countries/modded/mRDD.txt"
RDE = "setup/countries/modded/mRDE.txt"
RDF = "setup/countries/modded/mRDF.txt"
RDG = "setup/countries/modded/mRDG.txt"
RDH = "setup/countries/modded/mRDH.txt"
RDI = "setup/countries/modded/mRDI.txt"
RDJ = "setup/countries/modded/mRDJ.txt"
RDK = "setup/countries/modded/mRDK.txt"
RDL = "setup/countries/modded/mRDL.txt"
RDM = "setup/countries/modded/mRDM.txt"
RDN = "setup/countries/modded/mRDN.txt"
RDO = "setup/countries/modded/mRDO.txt"
RDP = "setup/countries/modded/mRDP.txt"
RDR = "setup/countries/modded/mRDR.txt"
RDS = "setup/countries/modded/mRDS.txt"
RDT = "setup/countries/modded/mRDT.txt"
RDU = "setup/countries/modded/mRDU.txt"
RDW = "setup/countries/modded/mRDW.txt"
RDY = "setup/countries/modded/mRDY.txt"
RDZ = "setup/countries/modded/mRDZ.txt"
REA = "setup/countries/modded/mREA.txt"
REC = "setup/countries/modded/mREC.txt"